C	S IY
CLOSE	K L OW S
CLOSE(2)	K L OW Z
D	D IY
DOWN	D AW N
EIGHT	EY T
FIRE	F AY ER
FIRE(2)	F AY R
FIVE	F AY V
FOUR	F AO R
FOX	F AA K S
GO	G OW
HI	HH AY
M	EH M
NINE	N AY N
ONE	W AH N
ONE(2)	HH W AH N
OPEN	OW P AH N
SAY	S EY
SCROLL	S K R OW L
SEVEN	S EH V AH N
SIX	S IH K S
SLEEP	S L IY P
TEN	T EH N
THREE	TH R IY
TO	T UW
TO(2)	T IH
TO(3)	T AH
TWO	T UW
UP	AH P